{
  "18": 1,
  "19": 2,
  "36": 3,
  "54": 4,
  "366": 5
}