{
  "src_to_inside": {
    "3681": 1,
    "3684": 2,
    "3688": 3,
    "3687": 4,
    "3682": 5,
    "5": 6,
    "3785": 7,
    "3758": 8,
    "3710": 9,
    "3711": 10,
    "3709": 11,
    "3695": 12,
    "3696": 13,
    "3707": 14,
    "3708": 15,
    "3717": 16,
    "3718": 17,
    "3716": 18,
    "3698": 19,
    "3699": 20,
    "3756": 21,
    "3757": 22,
    "3714": 23,
    "3715": 24,
    "3722": 25,
    "3723": 26,
    "3721": 27,
    "3731": 28,
    "3764": 29,
    "3765": 30,
    "3780": 31,
    "3781": 32,
    "3782": 33,
    "3735": 34,
    "3766": 35,
    "3700": 36,
    "3784": 37,
    "3773": 38,
    "3701": 39,
    "3702": 40,
    "3774": 41,
    "3786": 42,
    "3703": 43,
    "3704": 44,
    "3788": 45,
    "3789": 46,
    "3790": 47,
    "3751": 48,
    "3752": 49,
    "3753": 50,
    "3759": 51,
    "3760": 52,
    "3761": 53,
    "3697": 54,
    "1": 55,
    "3740": 56,
    "3683": 57,
    "25": 58,
    "3802": 59,
    "3803": 60,
    "3794": 61,
    "3796": 62,
    "3799": 63,
    "3800": 64,
    "3801": 65,
    "3804": 66,
    "3806": 67,
    "3811": 68,
    "3754": 69,
    "3762": 70,
    "3763": 71,
    "3805": 72,
    "3792": 73,
    "3793": 74,
    "3705": 75,
    "3706": 76,
    "3691": 77,
    "3797": 78,
    "3798": 79,
    "3725": 80,
    "3712": 81,
    "3713": 82,
    "3693": 83,
    "3727": 84,
    "3719": 85,
    "3720": 86,
    "3755": 87,
    "3795": 88,
    "3767": 89,
    "3768": 90,
    "3776": 91,
    "3778": 92,
    "3777": 93,
    "3775": 94,
    "3791": 95,
    "3685": 96,
    "3689": 97,
    "3809": 98,
    "3810": 99,
    "3745": 100,
    "3750": 101,
    "3746": 102,
    "3736": 103,
    "3737": 104,
    "3747": 105,
    "3749": 106,
    "3748": 107,
    "3807": 108,
    "3808": 109,
    "3787": 110,
    "3730": 111,
    "3739": 112,
    "3686": 113,
    "3692": 114,
    "3734": 115,
    "3724": 116,
    "3741": 117,
    "3742": 118,
    "3769": 119,
    "3770": 120,
    "3690": 121,
    "3694": 122,
    "3738": 123,
    "3726": 124,
    "3743": 125,
    "3744": 126,
    "3771": 127,
    "3772": 128,
    "3728": 129,
    "3729": 130,
    "3732": 131,
    "3733": 132,
    "3779": 133,
    "3783": 134
  },
  "inside_to_src": {
    "1": 3681,
    "2": 3684,
    "3": 3688,
    "4": 3687,
    "5": 3682,
    "6": 5,
    "7": 3785,
    "8": 3758,
    "9": 3710,
    "10": 3711,
    "11": 3709,
    "12": 3695,
    "13": 3696,
    "14": 3707,
    "15": 3708,
    "16": 3717,
    "17": 3718,
    "18": 3716,
    "19": 3698,
    "20": 3699,
    "21": 3756,
    "22": 3757,
    "23": 3714,
    "24": 3715,
    "25": 3722,
    "26": 3723,
    "27": 3721,
    "28": 3731,
    "29": 3764,
    "30": 3765,
    "31": 3780,
    "32": 3781,
    "33": 3782,
    "34": 3735,
    "35": 3766,
    "36": 3700,
    "37": 3784,
    "38": 3773,
    "39": 3701,
    "40": 3702,
    "41": 3774,
    "42": 3786,
    "43": 3703,
    "44": 3704,
    "45": 3788,
    "46": 3789,
    "47": 3790,
    "48": 3751,
    "49": 3752,
    "50": 3753,
    "51": 3759,
    "52": 3760,
    "53": 3761,
    "54": 3697,
    "55": 1,
    "56": 3740,
    "57": 3683,
    "58": 25,
    "59": 3802,
    "60": 3803,
    "61": 3794,
    "62": 3796,
    "63": 3799,
    "64": 3800,
    "65": 3801,
    "66": 3804,
    "67": 3806,
    "68": 3811,
    "69": 3754,
    "70": 3762,
    "71": 3763,
    "72": 3805,
    "73": 3792,
    "74": 3793,
    "75": 3705,
    "76": 3706,
    "77": 3691,
    "78": 3797,
    "79": 3798,
    "80": 3725,
    "81": 3712,
    "82": 3713,
    "83": 3693,
    "84": 3727,
    "85": 3719,
    "86": 3720,
    "87": 3755,
    "88": 3795,
    "89": 3767,
    "90": 3768,
    "91": 3776,
    "92": 3778,
    "93": 3777,
    "94": 3775,
    "95": 3791,
    "96": 3685,
    "97": 3689,
    "98": 3809,
    "99": 3810,
    "100": 3745,
    "101": 3750,
    "102": 3746,
    "103": 3736,
    "104": 3737,
    "105": 3747,
    "106": 3749,
    "107": 3748,
    "108": 3807,
    "109": 3808,
    "110": 3787,
    "111": 3730,
    "112": 3739,
    "113": 3686,
    "114": 3692,
    "115": 3734,
    "116": 3724,
    "117": 3741,
    "118": 3742,
    "119": 3769,
    "120": 3770,
    "121": 3690,
    "122": 3694,
    "123": 3738,
    "124": 3726,
    "125": 3743,
    "126": 3744,
    "127": 3771,
    "128": 3772,
    "129": 3728,
    "130": 3729,
    "131": 3732,
    "132": 3733,
    "133": 3779,
    "134": 3783
  }
}